11111111111111111111111111
1CCCCCCCCCCC11CCCCCCCCCCC1
1C1111C1111C11C1111C1111C1
1C1111C1111C11C1111C1111C1
1C1111C1111C11C1111C1111C1
1CCCCCCCCCCCCCCCCCCCCCCCC1
1C1111C1C11111111C1C1111C1
1CCCCCC1CCCC11CCCC1CCCCCC1
111111C111101101111C111111
111111C100000000001C111111
111111C101110011101C111111
1T0000C001000000100C0000T1
111111C101110011101C111111
111111C100000000001C111111
111111C101111111101C111111
1CCCCCCCCCCC11CCCCCCCCCCC1
1C1111C1111C11C1111C1111C1
1CCC11CCCCCCEPCCCCCC11CCC1
111C11C1C11111111C1C11C111
11CCCCC1CCCC11CCCC1CCCCCC1
1CC11111111C11C111111111C1
11CCCCCCCCCCCCCCCCCCCCCCC1
11111111111111111111111111