11111111111111111111111111
1CCCCCCCCCCC11CCCCCCCCCCC1
1C1111C1111C11C1111C1111C1
1U1111C1111C11C1111C1111U1
1C1111C1111C11C1111C1111C1
1CCCCCCCCCCCCCCCCCCCCCCCC1
1C1111C1C11111111C1C1111C1
1CCCCCC1CCCC11CCCC1CCCCCC1
111111C111101101111C111111
111111C10000MR00001C111111
111111C101110011101C111111
1ECCCCC001000000100CCCCCE1
111111C101110011101C111111
111111C10000O000001C111111
111111C101111111101C111111
1CCCCCCCCCCC11CCCCCCCCCCC1
1C1111C1111C11C1111C1111C1
1UCC11CCCCCCP0CCCCCC11CCU1
111C11C1C11111111C1C11C111
1CCCCCC1CCCC11CCCC1CCCCCC1
1C111111111C11C111111111C1
1CCCCCCCCCCCCCCCCCCCCCCCC1
11111111111111111111111111
