11111111111111111111111111
1CCCCCCCCCCC11CCCCCCCCCCC1
1C1111C1111C11C1111C1111C1
1U1111C1111C11C1111C1111U1
1C1111C1111C11C1111C1111C1
1CCCCCCCCCCCCCCCCCCCCCCCC1
1C1111C1C11111111C1C1111C1
1CCCCCC1CCCC1C1CCC1CCCCCC1
111111C1111C11C1111C111111
111111C1CCCCMRCCCC1C111111
111111C1C11100111C1C111111
1TCCCCCCC10000001CCCCCCCT1
111111C1C11100111C1C111111
111111C1CCCCOBCCCC1C111111
111111C1C11111111C1C111111
1CCCCCCCCCCC11CCCCCCCCCCC1
1C1111C1111C11C1111C1111C1
1UCC11CCCCCCPECCCCCC11CCU1
111C11C1C11111111C1C11C111
1CCCCCC1CCCC11CCCC1CCCCCC1
1C111111111C11C111111111C1
1CCCCCCCCCCCCCCCCCCCCCCCC1
11111111111111111111111111