1111111111111111111111111111111111111111111111111111111111
1UCCCCCCCCCCCCCCCCCCCCCCCCCCCCCCCCCCCCCCCCCCCCCCCCCCCCCCU1
1C111C111111111C111111111111111C11111111C111C11111C11111C1
1C111C111111111C111111111111111C11111111C111C11111C11111C1
1CCCCC111111111CCCCCCCCCCCCCCCCCCCCCCCCCC111CCCCCCCCCCCCC1
11111C111CCCCCCC1111111C11111110000RMOB00111C1111111C11111
11111C111C11111C1111111C11111110111111110111C1111111C11111
11111C111C11111C1100011C11000110100000010111C1100011C11111
1TCCCC111CCC111C1100011C11000110100000010111C1111111CCCCT1
11111C111111111C1100011C11000110111111110111C111CCCCC11111
11111C111111111C1111111C11111110000000000111C1111111C11111
11111C111111111C1111111C11111110111111110111C1111111C11111
1CCCCPECCCCCCCCCCCCCCCCCCCCCCCCC11111111CCCCCCCCCCCCCCCCC1
1C1111C1111111111C11C1111111111CCCC11CCCC111111111C11111C1
1C1111C1111111111C11C1111111111C11C11C11C111111111C11111C1
1UCCCCCCCCCCCCCCCC11CCCCCCCCCCCC11CCCC11CCCCCCCCCCCCCCCCU1
1111111111111111111111111111111111111111111111111111111111
